WWWWWWWWWWWWWWWW
WRGGGGGWGCGGGGGW
WGGGGGGWGGGGGGGW
WGGMGGGWGGGMGGGW
WGGWGGGMCGGMGGGW
WGGWGGGMGGGWGGGW
WPGWGGGGGGGWGGGW
WGCWGGGGGGGWGGEW
WWWWWWWWWWWWWWWW