WWWWWWWWWWWW
WRGGGMWGGGGW
WGGCGGWGGGGW
WGGGGGWGGCGW
WCGGGGWGGGGW
WPGGGMGGGGEW
WWWWWWWWWWWW