WWWWWWWWWWWWWWWW
WRGGGGGWGGGGGGCW
WGGGGGGWGGGGGGGW
WGGMGGGWGGGMGGGW
WGGWGGGMCGGMGGGW
WGGWGGGMGGGWGGGW
WPGWGGGGGGGWGGGW
WGCWGGGGGGGWGGEW
WWWWWWWWWWWWWWWW