WWWWWWWWWWWW
WRGGGMWGGGGW
WGGCGGWGGGGW
WGGGGGWGGCGW
WGGPGGWGGGGW
WCGGMGGGGGEW
WWWWWWWWWWWW