WWWWWWWWWWWWWWWW
WRGGGGGWGGGGGGGW
WGGGGGGWGGGGGGGW
WGGMGGGWGGGMGGGW
WGGWGGGMGGGMGGGW
WGGWGGGMGGGWGGGW
WPGWGGGGGGGWGGGW
WGGWGGGGGGGWGGEW
WWWWWWWWWWWWWWWW