WWWWWWWWWWWW
WRGGGMWGGGGW
WGGCGGWGGGGW
WGGGGGWGGCGW
WGGPGGWGGGGW
WCGGGMGGGGEW
WWWWWWWWWWWW