WWWWWWWW
WCCCCCCW
WCCPCCCW
WCCCCCCW
WWWWWWWW