WWWWWWWWWWW
WGGGGGECGGW
WPGGGMCGGGW
WGGGGGGGGLW
WGGGGGGGGCW
WWWWWWWWWWW