WWWWWWWW
WCCCCCCW
WCCCPCCW
WCCCCCCW
WWWWWWWW