WWWWWWWWWWW
WGGGGGGGGGW
WPGGGMGGGGW
WGGGGGGGGLW
WGGGGEGGGGW
WWWWWWWWWWW