WWWWWWWWWWWWWWWW
WRGGGGGWGCGGGGGW
WGGGGGGWGGGGGGGW
WGGMGGGWGGGMGGGW
WGGWGGGMCGGMGGGW
WGGWGGGMGGGWGEGW
WPGWGGGGGGGWGGGW
WGCWGGGGGGGWGGGW
WWWWWWWWWWWWWWWW