WWWWWWWWWWWWWWWWW
WWWWWWWGCGWWWWWWW
WGRGWGGGGGGWEGMGW
WGGGWPGMWGGWWGGGW
WGMGGMWGMGGGMGGGW
WCGGGGGGGGMGGGCGW
WWGWGGGGGGGGGGGGW
WWWWWWWWWWWWWWWWW