WWWWWWWWWWWWWWWWWWWWWWWWWWWWWWWWWW
WWWWWWWGCGWWWWWWWWWWWWWWGCGWWWWWWW
WGRGWGGGGGGWEGMGWWGGGWGGGGGGWGGMGW
WGGGWPGMWGGWWGGGGWGGGWMGMWGGWWGGGW
WGMGGMWGMGGGMGGGRGGGGGWWGGGGEGGGGW
WGGGGGGGGGMGGGGGGGGGGGGGGGGMGGGCGW
WWWWGGWWWGGGWWWWWWWWWGGGGGGGGWWWWW
WWWWWWWWWWWWWWWWWWWWWWWWWWWWWWWWWW
