WWWWWWWWWWWWWWWWWWWWWWWWWWWWWWWWWW
WWWWWWWGCGWWWWWWWWWWWWWWGCGWWWWWWW
WGRGWGGGGGGWEGMGWWGGGWGGGGGGWGGMGW
WGGGWPGMWGGWWGGGGWGGGWPGMWGGWWGGGW
WGMGGMWGMGGGMGGGRGGGGGWWGGGGEGGGGW
WGGGGGGGGGMGGGGGGGGGGGGGGGGMGGGCGW
WWWWGGWWWGGGWWWWWWWWWGGGGGGGGWWWWW
WWWWWWWWWWWWWWWWWWWWWWWWWWWWWWWWWW
