WWWWWWWWWW
WGGDGGEGCW
WGGGGGGGGW
WRGGGGGMGW
WGGGGGGGGW
WGGMGGEGGW
WCPGGGGGCW
WWWWWWWWWW